Andale_Mono	/usr/share/fonts/truetype/msttcorefonts/Andale_Mono.ttf
andalemo	/usr/share/fonts/truetype/msttcorefonts/andalemo.ttf
Arial_Italic	/usr/share/fonts/truetype/msttcorefonts/Arial_Italic.ttf
Arial	/usr/share/fonts/truetype/msttcorefonts/Arial.ttf
arialbd	/usr/share/fonts/truetype/msttcorefonts/arialbd.ttf
Arial_Bold_Italic	/usr/share/fonts/truetype/msttcorefonts/Arial_Bold_Italic.ttf
arialbi	/usr/share/fonts/truetype/msttcorefonts/arialbi.ttf
Arial_Bold	/usr/share/fonts/truetype/msttcorefonts/Arial_Bold.ttf
ariali	/usr/share/fonts/truetype/msttcorefonts/ariali.ttf
ariblk	/usr/share/fonts/truetype/msttcorefonts/ariblk.ttf
Arial_Black	/usr/share/fonts/truetype/msttcorefonts/Arial_Black.ttf
comicbd	/usr/share/fonts/truetype/msttcorefonts/comicbd.ttf
comic	/usr/share/fonts/truetype/msttcorefonts/comic.ttf
Comic_Sans_MS	/usr/share/fonts/truetype/msttcorefonts/Comic_Sans_MS.ttf
Comic_Sans_MS_Bold	/usr/share/fonts/truetype/msttcorefonts/Comic_Sans_MS_Bold.ttf
courbi	/usr/share/fonts/truetype/msttcorefonts/courbi.ttf
Courier_New_Italic	/usr/share/fonts/truetype/msttcorefonts/Courier_New_Italic.ttf
couri	/usr/share/fonts/truetype/msttcorefonts/couri.ttf
Courier_New	/usr/share/fonts/truetype/msttcorefonts/Courier_New.ttf
cour	/usr/share/fonts/truetype/msttcorefonts/cour.ttf
courbd	/usr/share/fonts/truetype/msttcorefonts/courbd.ttf
Courier_New_Bold	/usr/share/fonts/truetype/msttcorefonts/Courier_New_Bold.ttf
Courier_New_Bold_Italic	/usr/share/fonts/truetype/msttcorefonts/Courier_New_Bold_Italic.ttf
DejaVuSans	/usr/share/fonts/truetype/dejavu/DejaVuSans.ttf
DejaVuSans-Bold	/usr/share/fonts/truetype/dejavu/DejaVuSans-Bold.ttf
DejaVuSansMono	/usr/share/fonts/truetype/dejavu/DejaVuSansMono.ttf
DejaVuSansMono-Bold	/usr/share/fonts/truetype/dejavu/DejaVuSansMono-Bold.ttf
DejaVuSerif-Bold	/usr/share/fonts/truetype/dejavu/DejaVuSerif-Bold.ttf
DejaVuSerif	/usr/share/fonts/truetype/dejavu/DejaVuSerif.ttf
Georgia_Bold	/usr/share/fonts/truetype/msttcorefonts/Georgia_Bold.ttf
georgiab	/usr/share/fonts/truetype/msttcorefonts/georgiab.ttf
Georgia_Bold_Italic	/usr/share/fonts/truetype/msttcorefonts/Georgia_Bold_Italic.ttf
georgiaz	/usr/share/fonts/truetype/msttcorefonts/georgiaz.ttf
Georgia_Italic	/usr/share/fonts/truetype/msttcorefonts/Georgia_Italic.ttf
Georgia	/usr/share/fonts/truetype/msttcorefonts/Georgia.ttf
georgiai	/usr/share/fonts/truetype/msttcorefonts/georgiai.ttf
Impact	/usr/share/fonts/truetype/msttcorefonts/Impact.ttf
opens___	/usr/share/fonts/truetype/openoffice/opens___.ttf
Times_New_Roman	/usr/share/fonts/truetype/msttcorefonts/Times_New_Roman.ttf
Times_New_Roman_Italic	/usr/share/fonts/truetype/msttcorefonts/Times_New_Roman_Italic.ttf
timesbd	/usr/share/fonts/truetype/msttcorefonts/timesbd.ttf
Times_New_Roman_Bold_Italic	/usr/share/fonts/truetype/msttcorefonts/Times_New_Roman_Bold_Italic.ttf
Times_New_Roman_Bold	/usr/share/fonts/truetype/msttcorefonts/Times_New_Roman_Bold.ttf
timesi	/usr/share/fonts/truetype/msttcorefonts/timesi.ttf
timesbi	/usr/share/fonts/truetype/msttcorefonts/timesbi.ttf
times	/usr/share/fonts/truetype/msttcorefonts/times.ttf
trebucit	/usr/share/fonts/truetype/msttcorefonts/trebucit.ttf
Trebuchet_MS_Bold_Italic	/usr/share/fonts/truetype/msttcorefonts/Trebuchet_MS_Bold_Italic.ttf
trebuc	/usr/share/fonts/truetype/msttcorefonts/trebuc.ttf
trebucbd	/usr/share/fonts/truetype/msttcorefonts/trebucbd.ttf
Trebuchet_MS_Italic	/usr/share/fonts/truetype/msttcorefonts/Trebuchet_MS_Italic.ttf
Trebuchet_MS_Bold	/usr/share/fonts/truetype/msttcorefonts/Trebuchet_MS_Bold.ttf
trebucbi	/usr/share/fonts/truetype/msttcorefonts/trebucbi.ttf
Trebuchet_MS	/usr/share/fonts/truetype/msttcorefonts/Trebuchet_MS.ttf
Verdana_Italic	/usr/share/fonts/truetype/msttcorefonts/Verdana_Italic.ttf
Verdana_Bold	/usr/share/fonts/truetype/msttcorefonts/Verdana_Bold.ttf
Verdana	/usr/share/fonts/truetype/msttcorefonts/Verdana.ttf
verdanai	/usr/share/fonts/truetype/msttcorefonts/verdanai.ttf
verdanab	/usr/share/fonts/truetype/msttcorefonts/verdanab.ttf
verdanaz	/usr/share/fonts/truetype/msttcorefonts/verdanaz.ttf
Verdana_Bold_Italic	/usr/share/fonts/truetype/msttcorefonts/Verdana_Bold_Italic.ttf
Webdings	/usr/share/fonts/truetype/msttcorefonts/Webdings.ttf
